░▒▒▒▒▒▒▒▒▒▒▒▒▒▒▒▒▒▒▒▒▒▒▒▒▒▒▒▒▒▒▒▒▒▒▒▒▒▒▒▒▒▒▒▒▒▒▒▒▒▒▒▒▒▒▒▒▒▒▒▒▒▒▒▒▒▒▒▒▒▒▒▒▒▒▒▒▒▒▒▒▒▒▒▒▒▒▒▒▒▒▒▒▒▒▒▒▒▒▒▒▒▒▒▒▒▒▒▒▒▒▒▒▒▒▒▒▒▒▒▒▒▒▒▒▒▒▒▒▒▒▒▒▒▒▒▒▒▒▒▒▒▒▒▒▒▒▒▒▒▒▒▒▒▒▒▒▒▒▒▒▒▒▓                                                                                                    
░▒▓, ,                                                                                                                                                           ░▒▓    
░▒▓                                                  ,,,,,,,,,,,,,                                                                                               ░▒▓
░▒▓  ,          ,,,,,,,,,,,,,,                            ,,,,,,,,,,,,,,,                                                                                        ░▒▓
░▒▓                                                                                                                                                              ░▒▓
░▒▓     ,,,,,,,                                                                                ,,,,,,,,,,                                                        ░▒▓
░▒▓   ,,,,,,,,,                        ,,,,,,,,                                                                  ,,,,,,,,,,,,,,,,                                ░▒▓
░▒▓                                                                 ,,,,,,,,,,,,,,,,,,,,,,,,                                                                     ░▒▓
░▒▓                     ░▒▓░▒▓░▒▓  ░▒▓░▒▓░▒▓               ,,,,,,,,░▒▒▒▒▒▒▒▒▒▒▒▒▒▒▒▒▒▒▒▒▒▒▒▒▒▒▒▒▒▒▓                                                              ░▒▓
░▒▓                     ░▒▓░▒▓░▒▓  ░▒▓░▒▓░▒▓   ,,,,,,,,,,,,,,,,,,,,,,,                                                                                           ░▒▓
░▒▓                      ░▒▒▒▒▒▓    ░▒▒▒▒▒▓                                                    ,,,,,,,,,,,,,,,,,,,,,,,,,,,,,,,,,,                                ░▒▓
░▒▓                      ░▒▒░▒▒▓    ░▒▒░▒▒▓                                           ,,,,,,,,,,,                                                                ░▒▓
░▒▓                      ░▒▒▒▒▒▓    ░▒▒▒▒▒▓                                                                  ,,,,,,,,,,,,,,,                                     ░▒▓
░▒▓                      ░▒▒▒▒▒▒▒▒▒▒▒▒▒▒▒▒▓    ,,,,,,,,,,,,,,,,,        ,,,,,,,,,,,,,,,,,,,,,,                                                                   ░▒▓
░▒▓      ,,,,,,,,,       ░▒▒▒▒▒▒▒▒▒▒▒▒▒▒▒▒▓          ,,,,,,,,,,,,,                    ,,,,,,,,,,,,,,,,,,,,                                     ,,,,,,,,,,,,,,,,, ░▒▓
░▒▓      ,,,,,,,         ░▒▒▒▒▒▒░  ▓▒▒▒▒▒▒▓                    ░▒▒▒▒▒▒▒▒▒▒▒▒▒▒▒▒▒▒▒▒▒▒▒▒▒▒▒▒▒▒▓                           ,,,,,,,,,,,,,,,,,,,,,,                 ░▒▓
░▒▓                      ░▒▒▒▒▒▒░  ▓▒▒▒▒▒▒▓                          ░▒▒▒▒▒▒▒▒▒▓                              ,,,,,,,,,,,,,,,,,,,  ,,,,,,,,,,,,,,,,,             ░▒▓
░▒▓     ,,,,,,,,         ░▒▒▒▒▒▒░  ▓▒▒▒▒▒▒▓                           ░▒▒▒▒▒▒▒▒▒▓                                           ,,,,,,,,,,,                          ░▒▓
░▒▓                      ^^^^^^^^  ^^^^^^^^        ,,,,,,,,,,,,,,,,,,,,,,░▒▒▒▒▒▒▒▒▒▓             ░▒▒▒▒▒▒▒▒▒▒▒▒▒▒▒▒▒▒▒▒▒▒▒▒▒▒▒▒▒▓         ,,,,,           ,,,,,,  ░▒▓
░▒▓    ,,,,,,,,,,,,,,   ░▒▓          ░▒▓                                     ░▒▒▒▒▒▒▒▒▒▒▒▒▒▒▒▒▒▒▒▒▒▒▒▒▒▒▒▒▒▒▓           ,,,,,,,,,,,    ,,,,,,,,,,,,,,,,,,        ░▒▓
░▒▓                    ░▒▒▓          ░▒▒▒▒▒▒▒▒▓,,,,,                  ░▒▒▒▒▒▒▒▒▒▒▒▒▒▒▒▒▒▒▒▒▒▒▒▒▒▒▒▒▒                                ,,,,,,,,,,,,,,,,,,,,,,,      ░▒▓
░▒▓     ░▒▒▒▒▒▒▓        ░▒▓                 ░▒▓     ,,,,,,,                   ░▒▒▒▒▒▒▒▒▒▓                    ,,,,,,,,,,,,,,,,,,,,,,,,,,   ,,,,     ,,,,,,,,,,,,,,░▒▓
░▒▓                     ░▒▓                 ░▒▒▒▒▒▒▒▒▒▒▒▒▒▒▒▒▒▒▒▒▒▒▒▒▒▒▒▒▒▒▒▒▒▒▒▒▒▒▒▒▒▒▒▒▒▒▒▒▒▒▒▒▒▒                               ,,,,,,,,,,,,,,,,,,             ░▒▓
░▒▓                     ░▒▓               ░▒▒▒▓                           ░▒▓     ░▒▒▒▒▒▒▒▒▒▒▒▒▒▒▒▒▒▒▒▒▒▒▒▒▒▒▒▒▒▓       ░▒▒▒▒▒▒▒▒▒▒▒▒▒▒▒▒▒▒▒▒▒▒▒▒▒▒▒▒▒▒▒▒▒▓  ░▒▒▒▒▒▓
░▒▓                     ░▒▒▒▒▒▒▓     ░▒▒▒▒▒▒▒▒▒▓ ,,,,,,,,,,,,,,,,,,,,,,,,,░▒▓,,,,,,,,,,,,,,,,,,,,,,,       ░▒▒▒▒▒▒▒▒▒▒▒▒▒▒▒▒▒▒▒▒▒▒▒▒▒▒▒▒▒▓            ,,,,,,,,,  ░▒▓
░▒▓        ░▒▒▒▒▒▒▓                 ░▓ ░▓            ,,,,,,,,,,,,,,       ░▒▓                                 ,,,,,,,,,,,,,,,,,,,,,,,,,,,,,,,,,,,,,,,,           ░▒▓
░▒▓   ░▒▒▒▒▒▒▒▒▒▒▒▒▒▒▓                  ▒▓                                ░▒▓ ,,,,,,,,,      ,,,,,,,,,,                               ,,,,,,,,,,                 ░▒▓
░▒▓                               ░▒▒▒▒▓                                  ░▒▓                                ,,,,,,,,,,,                                         ░▒▓
░▒▓                     ░▒▒▒▒▒▒▒▒▒▒▒▓            ,,,,,,,,,,            ,,,░▒▓,,,,,,,,,,,                                          ,,,,,,,,,,                     ░▒▓
░▒▓   ░▒▒▒▒▒▒▓         ░▒▒▒▓      ░▒▒▒▓     ,,,,,,,,,               ,,,  ,░▒▓,,,,,,,,,,   ,,,,,,,,,,,,,,,,,,,,    ,,,,,,,,,,,,                       ,,,,,,,     ░▒▓
░▒▒▒▒▒▒▒▒▒▒▒▒▒▒▒▒▒▒▒▒▒▒▒▓    ░▒▓                 ,,,,,,,,,,               ░▒▓                                   ,,,,,,,,,,,,                        ,,,,,,,,,,,,,░▒▓
░▒▓        ░▒▓   ░▒▓          ░▒▓                            ,,,,,,,,,,,,,░▒▓,           ,,,,,,,,,,,,,,,,,,,,,,,  ,,,,,,,,,,                  ,,,,,,,,,,         ░▒▓
░▒▓     ,,,,,,,,,,,    ,,,,,,,,          ░▒▓       ,,,,,,,,,,             ░▒▓            ,,,,,,,,,,,,,,,,,              ,,,,,,,,,,,,                             ░▒▓
░▒▓             ,,,,,,,,,,,,,,,,           ░▒▓       ,,,,,,,,        ,,,,,░▒▓,,,,,,,,,,,,                ,,,,,,,,,,,,                                            ░▒▓
░▒▓         ,,,,,   ,,,,,,,,,,,,,,░▒▓             ,,,,,,,,,,,                                                                ,,,,,,,,,,,,,,,,                    ░▒▓
░▒▓ ,,,,,,,,       ,,,,,,   ,,,,,,,,,               ,,,,,,,,,,           ░▒▓   ,,,,,,,,,,,      ,,,,,,,,,,                                                       ░▒▓
░▒▓                  ,,,,,,,,,,,       ░▒▓         ,,,,,,,,,,,,,                                                                                                 ░▒▓
░▒▒▒▒▒▒▒▒▒▒▒▒▒▒▒▒▒▒▒▒▒▒▒▒▒▒▒▒▒▒▒▒▒▒▒▒▒▒▒▒▒▒▒▒▒▒▒▒▒▒▒▒▒▒▒▒▒▒▒▒▒▒▒▒▒▒▒▒▒▒▒▒▒▒▒▒▒▒▒▒▒▒▒▒▒▒▒▒▒▒▒▒▒▒▒▒▒▒▒▒▒▒▒▒▒▒▒▒▒▒▒▒▒▒▒▒▒▒▒▒▒▒▒▒▒▒▒▒▒▒▒▒▒▒▒▒▒▒▒▒▒▒▒▒▒▒▒▒▒▒▒▒▒▒▒▒▒▒▒▒▒▒▓
