░▒▒▒▒▒▒▒▒▒▒▒▒▒▒▒▒▒▒▒▒▒▒▒▒▒▒▒▒▒▒▒▒▒▒▒▒▒▒▒▒▒▒▒▒▒▒▒▒▒▒▒▒▒▒▒▒▒▒▒▒▒▒▒▒▒▒▒▒▒▒▒▒▒▒▒▒▒▒▒▒▒▒▒▒▒▒▒▒▒▒▒▒▒▒▒▒▒▒▒▒▒▒▒▒▒▒▒▒▒▒▒▒▒▒▒▒▒▒▒▒▒▒▒▒▒▒▒▒▒▒▒▒▒▒▒▒▒▒▒▒▒▒▒▒▒▒▒▒▒▒▒▒▒▒▒▒▒▒▒▒▒▒▓                                                                                                    
░▒▓      ,,,,                                 ▒▒                      ,,,,,,,,,,,,,,,                                                                            ░▒▓    
░▒▓      ,,     ,                            ▒▒                                                  ,,,,,,,,,,,,,,,,,,,    ,,,,,,,,,,,,,,,,,       ,,,,,,,,,,,,,,   ░▒▓    
░▒▓      ,,      ,,,,                       ▒▒  ,,,,,,,,,,,,,,,,,,,,,, ,,,,,,,,,,, ,,,,,,,,,,,,                          ,,,,,,,,,,,,,,,,                        ░▒▓    
░▒▓      ,,       ,,,                           ,,,,,,,,,,,,,,,                   ,,,,,,,,       ,,,,,,,,,,,,,,,,,,,,                                            ░▒▓    
░▒▓     ,,,      ,,,,,    ▒▒▒▒▒▒▒▒▒▒▒▒    ▒▒                        ,,,,,,,,,,,,,,,,,,        ,,,,,,,,,,,,,               ,,,,,,,,,,,,,,,,,                      ░▒▓    
░▒▓      ,,,,   ,,,,     ▒▒          ▒▒  ▒▒   ,,,,,,,,,,,,,,,,,,,,,,,,,,,,,,,,,,,,,,,,,      ,,,,,,,,,,,,,,        ,,,,,,,,,,,,,,,,                              ░▒▓    
░▒▓      ,,,    ,,      ▒▒            ▒▒▒▒    ,,,,,,,,,,,,,,,,,                     ,,,,,,,,,,,,,                        ,,,,,,,,,,,,,,,                         ░▒▓    
░▒▓       ,,    ,,,,   ▒▒    ,   ,       ▒▒    ,,,,,,,,,,              ,,,,,,,,,,,,                           ,,,,,,,,,,,,,,,,                                   ░▒▓    
░▒▓       ,,   ,,,    ▒▒           ,      ▒▒                  ,,,,,,,,,,,,,,,             ,,,,,,,,,,,,,,,,,,,,,,                                                 ░▒▓    
░▒▓        ,   ,,,,  ▒▒       ,,           ▒▒      ▒▒▒▒                 ,,,,,,,,,,,,,,,,,,,,,,,,,,,,,,     ,,,,,,,,,,,,,,,,,,,,,,,,,,,,,                         ░▒▓    
░▒▓        ,,       ▒▒     ,                ▒▒    ▒▒  ▒▒▒▒▒▒▒▒▒▒▒▒▒▒▒▒▒▒▒▒▒▒                                                                                     ░▒▓    
░▒▓    ,,,,,       ▒▒  ,,     ,     ,    ,   ▒▒  ▒▒                        ▒▒▒▒▒▒▒▒▒▒▒▒▒▒▒▒▒▒▒▒                                                  ,      ,        ░▒▓    
░▒▓  ,,,,,,       ▒▒     ,  ,   ,     ,       ▒▒▒▒                                            ▒▒▒▒▒▒▒▒▒▒▒▒▒▒▒▒▒▒▒             ,           ,                      ░▒▓    
░▒▓ ,            ▒▒     ,,          ,,         ▒▒                                                             ▒▒         ,                                       ░▒▓    
░▒▓ , ,,,,      ▒▒         ,  ,          , ,   ▒▒       ▒▒▒▒▒▒▒▒▒▒▒▒                                         ▒▒                       ,             ,            ░▒▓    
░▒▓,  ,,,,,,   ▒▒    ,,   ,  ,,,   ,     ,     ▒▒      ▒▒         ▒▒▒▒▒▒                                     ▒▒           ,        ,   ,   ,                     ░▒▓    
░▒▓  ,,,,,,,, ▒▒  ,,,  ,,         ,        ▒▒▒▒▒▒     ▒▒               ▒▒▒▒▒▒                               ▒▒      ,       ,                                    ░▒▓    
░▒▓ ,,,,,,,, ▒▒     ,,     ,         ,,   ▒▒         ▒▒                     ▒▒▒▒▒▒                           ▒▒                    ,                             ░▒▓    
░▒▓ ,,,,,,,,▒▒,,,,               ,,,     ▒▒    ▒▒   ▒▒                        ▒▒                            ▒▒    ,,                         , ,                 ░▒▓    
░▒▓ ,,,,,,,,▒▒,,,    ,,   ,,,           ▒▒     ▒▒▒▒▒▒                         ▒▒                             ▒▒            ,          , ,          ,             ░▒▓    
░▒▓ ,,,,,,,,▒▒ ,,,      ,    ,,      ▒▒▒▒     ▒▒▒▒                             ▒▒                            ▒▒       ,  ,                                ,      ░▒▓    
░▒▓ ,,,,,,,,▒▒  ,  ,,,              ▒▒       ▒▒  ▒▒                          ▒▒▒                            ▒▒                   ,  ,                            ░▒▓    
░▒▓ ,,,,,,,    ,,         ▒▒▒▒▒▒▒▒▒▒▒       ▒▒    ▒▒▒▒▒▒▒▒▒▒▒▒▒         ▒▒▒▒▒▒                                ▒▒                ,       ,                        ░▒▓   
░▒▓ ,,,,,,, ▒▒ ,,,  ▒▒▒▒▒▒▒▒               ▒▒     ▒▒  ▒▒                  ▒▒                     ▒▒▒▒▒▒▒▒▒▒▒▒▒▒▒▒   ,                  ,         ,, ,            ░▒▓    
░▒▓ ,,,,,,, ▒▒▒▒▒▒▒▒▒▒                    ▒▒                           ▒▒▒▒▒              ▒▒▒▒▒▒▒▒▒▒▒         ▒▒▒▒▒▒▒▒▒▒▒                                        ░▒▓    
░▒▓ ,,,,,,, ▒▒                           ▒▒      ▒▒▒▒▒▒▒▒▒▒▒▒▒▒▒▒▒▒▒▒▒▒▒              ▒▒▒▒▒▒▒▒▒▒▒                   ▒▒▒▒▒▒▒▒▒▒▒                                  ░▒▓    
░▒▓ ,,,,,,, ▒▒                          ▒▒      ▒▒                                      ▒▒▒                                          ,                     ,     ░▒▓    
░▒▓ ,,,,,,, ▒▒                        ▒▒▒       ▒▒                                       ▒▒▒,,,,,,,,,,,,,,,,,,,,,,,,,,,,,,,,,,,,,,,,,,,,,,,,,,,,,,,,,,,,,,,,,,,,,░▒▓    
░▒▓ ,,,,,,, ▒▒                       ▒▒         ▒▒                                      ▒▒▒                                                                      ░▒▓    
░▒▓ ,,,,,,, ▒▒                      ▒▒        ▒▒                                        ,,,,,,,,,,,,,,,,,,,,,,,,,,,,,,,,,,,,,,,,,,,,,,,,,,,,,,,,,,,,,,,,,,,,,,,,,░▒▓    
░▒▓ ,,,,,,,  ▒▒                     ▒▒      ▒▒▒▒                                                                                                                 ░▒▓    
░▒▓ ,,,,,,,   ▒▒                ,,,,,,,,    ▒▒                                                                                                                   ░▒▓    
░▒▓ ,,,,,,,    ▒▒               ,,,,,,,,    ▒▒                                                                                                                   ░▒▓    
░▒▓ ,,,,,,,     ▒▒              ,,,,,,,,     ▒▒                                                                                                                  ░▒▓    
░▒▓ ,,,,,,,      ▒▒             ,,,,,,,,    ▒▒                                                                                                                   ░▒▓    
░▒▓               ▒▒            ,,,,,,,,    ▒▒                                                                                                                   ░▒▓    
░▒▒▒▒▒▒▒▒▒▒▒▒▒▒▒▒▒▒▒▒▒▒▒▒▒▒▒▒▒▒▒▒▒▒▒▒▒▒▒▒▒▒▒▒▒▒▒▒▒▒▒▒▒▒▒▒▒▒▒▒▒▒▒▒▒▒▒▒▒▒▒▒▒▒▒▒▒▒▒▒▒▒▒▒▒▒▒▒▒▒▒▒▒▒▒▒▒▒▒▒▒▒▒▒▒▒▒▒▒▒▒▒▒▒▒▒▒▒▒▒▒▒▒▒▒▒▒▒▒▒▒▒▒▒▒▒▒▒▒▒▒▒▒▒▒▒▒▒▒▒▒▒▒▒▒▒▒▒▒▒▒▒▓
